6 6
100 100
R R P P F F
S R R P F F
S M R R M S
S M R R M S
F F P R R S
F F P P R R
